.............
.............
.............
......1......
......1......
.............
.,.00...22...
.............
......3......
......3......
.............
.............
.............