.............
........2....
..00....222..
..000...222..
...000..2222.
....00..2222.
.,.......222.
....11..2222.
...111..2222.
..111...222..
..11....222..
........2....
.............