.............
.............
.............
.............
...11000011..
...11000011..
.,.11000011..
...11000011..
...11000011..
.............
.............
.............
.............