.............
.............
.............
.............
...22223333..
...22223333..
.,.22223333..
...22223333..
...22223333..
.............
.............
.............
.............